########
# #    #
# A    #
#   ####
#   ####
##    ##
# B### #
########
