##################################################
#      #       #  # ### # #### #   ###   #  #   ##
#   #  #  ###     #   #       #     ##   #     # #
##   #    #     ##### ##   #  ## ##     # #    ###
#### # ##      ## #      ##   # ##  # #  #   #  ##
##  #  ##       #  ##      # ####  #   ## ##   # #
# # #  ##     ###  #  # #    ##      # # ##  #   #
##  #  # ## ##  #  #  #### #     #     ####    # #
#       #   #### # # #  #     #   #    ##   ###  #
####  #  #          #  # #       #  #       ###  #
#  # ## ## ## # #  # ### # #  ## ##    # #    ####
#  ### ##  #  #  #  # #   #    # #      #### #  ##
#  #  ## # #  # #  ##      # ##   #   #    #   ###
##         # #     #       #  ##    ##    # #### #
# #    #   # #  #A    ### ## ## ##     # ##  # ###
#  #    # ##     #  # ###         #       # #   ##
#### ### # #    #  #         #  # # ## ## # #    #
##   # #  #   ##   # # #  # #    #  ###   ## ##  #
#    #    #  #    ##     #    #  #  # #  ##  # # #
#  ##   ##  # #      # #   ##       #  ##  ##    #
#       #  #  ###   #     # #    ## #  #        ##
# #             ##### ##  # ## #    # ####       #
#  ##   #   ####       # #  #   # ## #    # #   ##
# ##           #     ##            ##      #     #
# #        ###     # #     # #   # #             #
#  #  #  ##       ##  # ##        #  # #####     #
#   #   #     #  #                ##  #    ##    #
#       #    #  ## ##   #    ### ### #    # #    #
#  #    # ##     # #    #      ## ## ###    # #  #
##     # # # # #    #   ##  # ##   ###   # ##  ###
#     B    ## #  #  # #   ## ##     #  #  # #  # #
###   ###    ##        #   ##   #  #    #     #  #
#        #     ##  ### # #    # # ## ##   #      #
# #     # #       #     # # #    ##  #   #    # ##
## ##   # # ##  # #  # # #         ### #  #     ##
#       # #  ####   #   #   #     # #     # #    #
##   ## # #    # # ###       #  ##   ## ## ###   #
#  #    # ####   #### # #  # # # #  # #   ##     #
# # #       # ##  # #           # #             ##
#  #   ##   #  #  ##  #     ##     ##     ## ##  #
#    #           #  ## ## #   # ##  #     #     ##
#     # #      ## #   ##    ## #  ##  # #  # #  ##
#    # ## ## # # #####  #    #    # # ##   ## #  #
# ## # #  #    #     # #      #      ##      # # #
# #     #     #   ## #  # #     #  ##  ###  #    #
# #  ##     ### ##  ####    ##   #   ##  ### #  ##
#    ##      # #      #    #    #       #    #   #
#   #  #       #  ## ####   #### # # # #   # ##  #
#    #    # #### # #  ### #      #  #      #   # #
##################################################
